30 30
##############################
#7777777777777777777776666666#
#7777777777777777777776666666#
#7777777777777777777776666666#
#7777777777777777777776666666#
#7777777777777777777776666666#
#********#############6666666#
#11111111#############6666666#
#11111111#############6666666#
#11111111#############6666666#
#11111111#############6666666#
#11111111#############5555555#
#11111111#############5555555#
#11111111#############5555555#
#11111111#############5555555#
#11111111#############5555555#
#11111111#############5555555#
#22222222#############5555555#
#22222222#############5555555#
#22222222#############5555555#
#22222222#############5555555#
#22222222#############5555555#
#22222222#############5555555#
#22222222#############5555555#
#2222222233333333344444444444#
#2222222233333333344444444444#
#2222222233333333344444444444#
#2222222233333333344444444444#
#2222222233333333344444444444#
##############################
