30 30
##############################
######777777777777777766######
####7777777777777777776666####
###777777777777777777766666###
##77777777777777777777666666##
##77777777777777777777666666##
#********#############6666666#
#111111111############6666666#
##111111111###########6666666#
###111111111##########6666666#
####111111111#########6666666#
####111111111#########6666666#
####111111111#########5555555#
###111111111########5555555###
##111111111#######5555555#####
#111111111#####55555555#######
#11111111####55555555#########
#22222222####55555555#########
#22222222####55555555#########
#22222222####55555555#########
#22222222######55555555#######
#22222222#########5555555#####
#22222222###########5555555###
##2222222#############5555555#
##222222233333333344444444444#
###22222233333333344444444444#
###2222223333333334444444444##
#####22223333333334444444444##
#######2233333333344444444####
##############################
