-------------------
- Title: Circuit 2
- Author: g543
-------------------
11 10
##########
#*9999999#
#11####99#
#11####88#
#2222##88#
###33##88#
###33##88#
#4444##88#
#55####77#
#55666666#
##########
